{
    "1":[
        ["box", 1, 0],
        ["box", 1, 1],
        ["box", 1, 2],
        ["box", 1, 3],
        ["box", 2, 3],
        ["box", 3, 3],
        ["box", 4, 3],
        ["box", 5, 3],
        ["box", 5, 2],
        ["box", 5, 1],
        ["box", 5, 0],
        ["box", 7, 1],
        ["box", 7, 2],
        ["box", 7, 3],
        ["box", 7, 4],
        ["box", 8, 1],
        ["box", 8, 2],
        ["box", 8, 3],
        ["box", 8, 4]
    ]
}